9,9,9,9,9,9,9,9,9,9
9,4,5,9,-1,5,5,3,9,9
9,4,3,4,3,3,3,4,3,9
9,9,9,3,5,3,4,3,4,4
9,9,9,3,4,4,3,3,3,5
9,4,4,3,3,3,5,4,4,3
9,3,5,3,3,3,4,3,3,9
9,9,5,3,4,9,9,4,4,9
9,9,9,4,3,9,9,3,5,9
9,9,9,9,3,9,9,9,9,9
