1,1,10,0,9,1,1,1,2,9
10,0,0,10,9,0,10,10,2,2
1,10,0,2,10,8,8,8,8,1
0,1,9,8,8,8,2,2,8,8
10,2,8,8,1,0,1,2,9,0
10,8,8,2,9,1,10,2,0,2
1,8,2,9,10,9,0,10,0,0
9,8,1,1,2,2,10,2,2,2
9,8,0,1,10,9,2,2,1,9
2,8,2,9,1,1,0,10,0,10
