2,1,1,6,8,7,7,7,7,6
10,0,1,8,6,6,8,6,8,6
1,10,2,8,8,6,6,7,6,6
0,1,0,1,1,1,1,0,0,0
10,2,1,0,1,0,0,0,0,0
2,10,0,0,0,1,10,2,0,0
0,1,0,9,0,0,0,10,0,0
0,0,1,1,2,0,0,0,0,0
0,0,0,1,0,0,0,2,0,9
0,0,2,0,1,1,0,10,0,10
