6,6,6,6,6
6,6,6,8,6
2,2,2,8,8
2,2,2,2,2
2,2,2,2,2
