9,0,0,2,9,0,0,10,1,9
1,9,2,2,9,1,1,0,0,0
2,9,2,1,1,9,1,9,2,10
1,2,9,2,1,0,0,0,10,9
0,0,2,1,2,1,10,10,1,0
10,2,10,9,2,2,1,0,9,10
1,2,2,10,1,0,2,9,1,0
10,2,10,10,0,0,1,0,1,1
2,1,10,10,9,2,9,9,10,1
1,1,1,9,1,9,0,1,0,9
